1111111111111111111111111111111111
1EH000000000000C00000C000V00000001
1010010100100000101001000000010101
101001001010101000100100H000010101
10P000000C00C000000000000000H000C1
1111111111111111111111111111111111