11111111111111111111111111111111111111111111
10111011101110110000011001001100000011000001
10111011101110110111011010101111110111011101
10PEC011100000110000011011101111101111000001
10111011101110110111011011101111011111011101
10111011101110110111011011101100000011011101
11111111111111111111111111111111111111111111